___T__TB
__T__TTT
_B_____T
TTTT_T_T
____X___
B______B