___T__T_
__T__TTT
_______T
TTTT_T_T
____X___
________